qid,Data_Pembelian,Data_Penjualan,Stok_Barang,Stok_Sisa,Bulan,Extra Stok
q1,300,317,320,3,1,1
q2,250,247,250,3,2,1
q3,300,326,330,4,3,1
q4,400,395,400,5,4,1
q5,400,404,410,6,5,0
q6,420,407,410,3,6,1
q7,430,426,430,4,7,0
q8,350,330,340,10,8,1
q9,300,312,320,8,9,1
q10,300,278,280,2,10,0
q11,300,265,270,5,11,1
q12,400,370,370,0,12,0
q13,450,419,420,1,1,0
q14,300,298,300,2,2,0
q15,320,313,320,7,3,0
q16,350,305,310,5,4,1
