qid,Data_Pembelian,Data_Penjualan,Stok_Barang,Stok_Sisa,Bulan,Prediksi
q1,300,317,320,3,1,
q2,250,247,250,3,2,
q3,300,326,330,4,3,
q4,400,395,400,5,4,
q5,400,404,410,6,5,
q6,420,407,410,3,6,
q7,430,426,430,4,7,
q8,350,330,340,10,8,
q9,300,312,320,8,9,
q10,300,278,280,2,10,
q11,300,265,270,5,11,
q12,400,370,370,0,12,
q13,450,419,420,1,1,
q14,300,298,300,2,2,
q15,320,313,320,7,3,
q16,350,305,310,5,4,
